11 18 2
558 558 558 558 558 558 558 558 558 558 558 558 558 558 558 558 558 558
558 703 703 703 703 703 703 703 703 703 703 703 703 703 703 703 703 558
558 548 548 548 548 548 548 548 548 548 548 548 548 548 548 548 548 558
558 548 548 548 548 548 548 548 548 548 548 548 548 548 548 548 548 558
558 548 548 548 548 548 548 548 548 548 548 548 548 548 548 548 548 558
558 548 548 548 548 548 548 548 548 548 548 548 548 548 548 548 548 558
558 548 548 548 548 548 548 548 548 548 548 548 548 548 548 548 548 558
558 548 548 548 548 548 548 548 548 548 548 548 548 548 548 548 548 558
558 548 548 548 548 548 548 548 548 548 548 548 548 548 548 548 548 558
558 548 548 548 548 548 548 548 548 548 548 548 548 548 548 548 548 558
558 558 558 558 558 558 558 558 558 558 558 558 558 558 558 558 558 558
558 558 558 558 558 558 558 558 558 558 558 558 558 558 558 558 558 558
558 702 703 703 703 703 703 703 785 786 902 703 703 703 906 703 704 558
558 707 558 558 558 558 558 558 825 826 942 558 558 558 946 829 744 558
558 747 625 626 627 624 558 558 558 558 982 983 984 985 986 558 744 558
558 742 665 666 667 664 558 558 558 558 557 542 543 544 557 558 744 558
558 742 558 558 558 558 558 558 558 558 557 582 583 584 557 558 744 558
558 742 385 387 387 388 558 558 558 558 557 558 558 558 557 558 744 558
558 742 465 467 467 428 558 558 558 558 558 558 558 558 558 558 744 558
558 787 505 506 506 508 558 558 558 558 558 558 558 558 558 558 744 558
558 782 783 783 783 783 783 783 783 783 783 783 783 783 783 783 784 558
558 558 558 558 558 558 558 558 558 558 558 558 558 558 558 558 558 558
1 1 1 1 1 1 1 1 1 1 1 1 1 1 1 1 1 1
1 1 1 1 1 1 1 1 1 1 1 1 1 1 1 1 1 1
1 0 0 0 0 0 0 0 0 0 0 0 0 0 0 0 0 1
1 0 0 0 0 0 0 0 0 0 0 0 0 0 0 0 0 1
1 0 0 0 0 0 0 0 0 0 0 0 0 0 0 0 0 1
1 0 0 0 0 0 0 0 0 0 0 0 0 0 0 0 0 1
1 0 0 0 0 0 0 0 0 0 0 0 0 0 0 0 0 1
1 0 0 0 0 0 0 0 0 0 0 0 0 0 0 0 0 1
1 0 0 0 0 0 0 0 0 0 0 0 0 0 0 0 0 1
1 1 1 1 1 1 1 1 1 1 1 1 1 1 1 1 1 1
1 1 1 1 1 1 1 1 1 1 1 1 1 1 1 1 1 1