9 16 2
702 703 703 703 703 703 703 785 786 902 703 703 703 906 703 704
742 779 779 779 779 779 779 825 826 942 779 779 779 946 829 744
742 625 626 627 624 779 779 779 779 982 983 984 985 986 779 744
742 665 666 667 664 779 779 779 779 557 542 543 544 557 779 744
742 779 779 779 779 779 779 779 779 557 582 583 584 557 779 744
707 385 387 387 388 779 779 779 779 557 558 558 558 557 779 744
747 465 467 467 428 779 779 779 779 558 558 558 558 558 779 744
787 505 506 506 508 779 779 779 779 779 779 779 779 779 779 744
782 783 783 783 783 783 783 783 783 783 783 783 783 783 783 784
703 703 703 703 703 703 703 703 703 703 703 703 703 703 703 703
742 548 548 548 548 548 548 548 548 548 548 548 548 548 548 742
742 548 548 548 548 548 548 548 548 548 548 548 548 548 548 742
742 548 548 548 548 548 548 548 548 548 548 548 548 548 548 742
742 548 548 548 548 548 548 548 548 548 548 548 548 548 548 742
742 548 548 548 548 548 548 548 548 548 548 548 548 548 548 742
742 548 548 548 548 548 548 548 548 548 548 548 548 548 548 742
742 548 548 548 548 548 548 548 548 548 548 548 548 548 548 742
703 703 703 703 703 703 703 703 703 703 703 703 703 703 703 703
1 1 1 1 1 1 1 1 1 1 1 1 1 1 1 1
1 0 0 0 0 0 0 0 0 0 0 0 0 0 0 1
1 0 0 0 0 0 0 0 0 0 0 0 0 0 0 1
1 0 0 0 0 0 0 0 0 0 0 0 0 0 0 1
1 0 0 0 0 0 0 0 0 0 0 0 0 0 0 1
1 0 0 0 0 0 0 0 0 0 0 0 0 0 0 1
1 0 0 0 0 0 0 0 0 0 0 0 0 0 0 1
1 0 0 0 0 0 0 0 0 0 0 0 0 0 0 1
1 1 1 1 1 1 1 1 1 1 1 1 1 1 1 1